BD = Bedfordshire
BE = Berkshire
BR = Bristol
BU = Buckinghamshire
CA = Cambridgeshire
CH = Cheshire
CO = Cornwall
CD = County Durham
CU = Cumberland
DE = Derbyshire
DV = Devon
DO = Dorset
EX = Essex
GL = Gloucestershire
HA = Hampshire
HE = Hertfordshire
HU = Huntingdonshire
KE = Kent
LA = Lancashire
LE = Leicestershire
LI = Lincolnshire
MI = Middlesex
NF = Norfolk
NH = Northamptonshire
NU = Northumberland
NO = Nottinghamshire
OX = Oxfordshire
RU = Rutland
SH = Shropshire (Salop)
SO = Somerset
ST = Staffordshire
SF = Suffolk
SU = Surrey
SX = Sussex
WA = Warwickshire
WE = Westmorland
WI = Wiltshire
WO = Worcestershire
YO = Yorkshire
